11111111111
10012001201
10112011521
11102122101
10000055121
11121212001
10102010121
12112022201
12101212021
11120202111
11111111111
