11111111111111111111
10101210101010101021
10002000220222022001
10121010101212121021
10000000000200200021
10101010101010101001
10022220000002000021
10101212100210121521 
10020250002000200001
11111111111111111111
